Pearl Jam - Better Man, Breath, Animal
Bhi Bhiman - Death Song
Derek Trucks - Sweet Inspiration
Ennai Noki Paayum Thota - Maruvaarthai
L. Subramaniam & Pt. Bismillah Khan - Sangeet Sangam
The Winery Dogs - I'm no Angel
Richie Kotzen - Save me
Coke Studio Pakistan - Hina ki Khushbu
Coke Studio Pakistan - Fareed Ayaz, Abu Muhammad - Rang
Coke Studio Pakistan - Racchel Viccaji - Ki Dam Da Bharosa
Veppam - Mazhai Varum
Prateek Kuhad - Raat Raazi
Nicholson - Cold Water
Kumaresh and Ganesh - Violin
John Mayer - Gravity / Moving on and Getting Over / Slow Dancing in a Burning Room
Maroon 5 - Don't Wanna Know
Marcus King - Rita is Gone
Kaatru Veliyidai - Saarattu Vandiyila
Parekh & Singh - Ghost
Hariharan - Maikade Bandh/Kaash/Yeh Aine se
Papon Coke Studio - Khumaar, Dinae Dinae
The Beastie Boys - Sabotage
Nirvana - Heart Shaped Box
The Beatles - I me mine, The end, I saw her standing there, Lady Madonna
Sound City OST - Cut Me Some Slack (McCartney/Grohl)
Paarthale Paravasam - Anbe Sugama (Because Raag Jaijaiwanti)
Euphoria - Ab Na Jaa
Jethro Tull - Someday the Sun won't shine for you
Debasmita Bhattacharya - Raag Bhimpalasi
Sudha Raghunathan - Raga Abheri
The Foo Fighters - Learn to Fly
Ondu Motteya Kathe - Keli Nodri (Motte Song)
Rage against the Machine - Killing in The Name
Cheb Khaled - Didi
Rahat Fateh / Nusrat Fateh Ali Khan - Mere Rashke Kamar
Papon, Anweshaa - Benaam Khwahishein
Peter Frampton - All I Want To Be (Is By Your Side)
Reid - I Know Why (Sofar, YouTube)
Jeff Buckley - The Way Young Lovers Do
Greta Van Fleet - Highway Tunes, Black Smoke Rising
SEREBRO - CHOCOLATE | Matvey Emerson Rework
